%%%%%%%%%%%%%%%%%%%%%%%%%%%%%%%%%%%%%%%%%
%                 %%%%%%%%%%%%%%%%%%%%%%%
%                 %%%%%%%%%%%        %%%%
%   %%%%%%%%%%    %%%%%%%%%%%        %%%%
%   %%%%%%%%%%    %%%%%%%%%%%        %%%%
%   %%%%%%%%%%                       %%%%
%   %%%%%%%%%%                       %%%%
%   %%%%%%%%%%    %%%%%%%%%%%        %%%%
%   %%%%%%%%%%    %%%%%%%%%%%        %%%%
%                 %%%%%%%%%%%        %%%%
%                 %%%%%%%%%%%%%%  %%%%%%%
%%%%%%%%  %%%%%%%%%%%%%%%%%%%%%%  %%%%%%%
%                 %%%%%%%%%%%%%%  %%%%%%%
%                 %%%%%%%%%%%        %%%%
%   %%%%%%%%%%    %%%%%%%%%%%        %%%%
%   %%%%%%%%%%    %%%%%%%%%%%        %%%%
%   %%%%%%%%%%                       %%%%
%   %%%%%%%%%%                       %%%%
%   %%%%%%%%%%    %%%%%%%%%%%        %%%%
%   %%%%%%%%%%    %%%%%%%%%%%        %%%%
%   %%%%%%%%%%    %%%%%%%%%%%        %%%%
%   %%%%%%%%%%    %%%%%%%%%%%        %%%%
%   %%%%%%%%%%    %%%%%%%%%%%        %%%%
%   %%%%%%%%%%                       %%%%
%   %%%%%%%%%%                       %%%%
%   %%%%%%%%%%    %%%%%%%%%%%        %%%%
%   %%%%%%%%%%    %%%%%%%%%%%        %%%%
%                 %%%%%%%%%%%        %%%%
%                 %%%%%%%%%%%%%%  %%%%%%%
%%%%%%%%  %%%%%%%%%%%%%%%%%%%%%%  %%%%%%%
%                 %%%%%%%%%%%%%%  %%%%%%%
%                 %%%%%%%%%%%        %%%%
%   %%%%%%%%%%    %%%%%%%%%%%        %%%%
%   %%%%%%%%%%    %%%%%%%%%%%        %%%%
%   %%%%%%%%%%                       %%%%
%   %%%%%%%%%%                       %%%%
%   %%%%%%%%%%    %%%%%%%%%%%        %%%%
%   %%%%%%%%%%    %%%%%%%%%%%        %%%%
%                 %%%%%%%%%%%        %%%%
%                 %%%%%%%%%%%%%%%%%%%%%%%
%%%%%%%%%%%%%%%%%%%%%%%%%%%%%%%%%%%%%%%%%
