%%%%%%%%%%%%%%%%%%%%%%%%%%%%%%%%%%%%%%%%%
%                                       %
%                                       %
%                                       %
%                                       %
%    %%%%%%%%%%%%%%%%%%%%%%%%%%%%%%%    %
%    %              %              %    %
%    %              %              %    %
%    %              %              %    %
%    %              %              %    %
%    %    %%%%%%%%  %  %%%%%%%%    %    %
%    %    %         %         %    %    %
%    %    %         %         %    %    %
%    %    %         %         %    %    %
%    %    %         %         %    %    %
%    %    %    %%%%%%%%%%%    %    %    %
%    %    %    %    %    %    %    %    %
%    %    %    %    %    %    %    %    %
%    %    %    %    %    %    %    %    %
%         %         %         %         %
%         %                   %         %
%         %         %         %         %
%    %    %    %    %    %    %    %    %
%    %    %    %    %    %    %    %    %
%    %    %    %    %    %    %    %    %
%    %    %    %%%%%%%%%%%    %    %    %
%    %    %         %         %    %    %
%    %    %         %         %    %    %
%    %    %         %         %    %    %
%    %    %         %         %    %    %
%    %    %%%%%%%%  %  %%%%%%%%    %    %
%    %              %              %    %
%    %              %              %    %
%    %              %              %    %
%    %              %              %    %
%    %%%%%%%%%%%%%%%%%%%%%%%%%%%%%%%    %
%                                       %
%                                       %
%                                       %
%                                       %
%%%%%%%%%%%%%%%%%%%%%%%%%%%%%%%%%%%%%%%%%
