%%%%%%%%%%%%%%%%%%%%%%%%%%%%%%%%%%%%%%%%%
%                                       %
%                                       %
%                                       %
%                                       %
%    %%%%%%%%%%%%%%% %%%%%%%%%%%%%%%    %
%    %                             %    %
%    %                             %    %
%    %                             %    %
%    %                             %    %
%    %    %%%%%%%%%% %%%%%%%%%%    %    %
%    %    %                   %    %    %
%    %    %                   %    %    %
%    %    %                   %    %    %
%    %    %                   %    %    %
%    %    %    %%%%%%%%%%%    %    %    %
%    %    %    %         %    %    %    %
%    %    %    %    %    %    %    %    %
%    %    %    %    %    %    %    %    %
%         %         %         %         %
%                   %                   %
%         %         %         %         %
%    %    %    %    %    %    %    %    %
%    %    %    %    %    %    %    %    %
%    %    %    %         %    %    %    %
%    %    %    %%%%%%%%%%%    %    %    %
%    %    %                   %    %    %
%    %    %                   %    %    %
%    %    %                   %    %    %
%    %    %                   %    %    %
%    %    %%%%%%%%     %%%%%%%%    %    %
%    %                             %    %
%    %                             %    %
%    %                             %    %
%    %                             %    %
%    %%%%%%%%%%%%%%% %%%%%%%%%%%%%%%    %
%                                       %
%                                       %
%                                       %
%                                       %
%%%%%%%%%%%%%%%%%%%% %%%%%%%%%%%%%%%%%%%%
