%%%%%%%%%%%%%%%%%%%%%%%%%%%%%%%%%%%%%%%%%
%                                       %
%                                       %
%    %%%%%%%%%%%%%%%%%%%%%%%%%%%%%%%    %
%                   %                   %
%  %                %                %  %
%  %                %                %  %
%  %                %                %  %
%  %                %                %  %
%  %                %                %  %
%  %                %                %  %
%  %                %                %  %
%  %                %                %  %
%  %                %                %  %
%  %                %                %  %
%  %                %                %  %
%  %                %                %  %
%  %                %                %  %
%  %                %                %  %
%  %                                 %  %
%  %%%%%%%%%%%%%%%%   %%%%%%%%%%%%%%%%  %
%  %                                 %  %
%  %                %                %  %
%  %                %                %  %
%  %                %                %  %
%  %                %                %  %
%  %                %                %  %
%  %                %                %  %
%  %                %                %  %
%  %                %                %  %
%  %                %                %  %
%  %                %                %  %
%  %                %                %  %
%  %                %                %  %
%  %                %                %  %
%  %                %                %  %
%                   %                   %
%    %%%%%%%%%%%%%%%%%%%%%%%%%%%%%%%    %
%                                       %
%                                       %
%%%%%%%%%%%%%%%%%%%%%%%%%%%%%%%%%%%%%%%%%
