%%%%%%%%%%%%%%%%%%%%%%%%%%%%%%%%%%%%%%%%%
%                                       %
%                                       %
%    %%%%%%%%%%%%%%   %%%%%%%%%%%%%%    %
%                   %                   %
%  %                %                %  %
%  %                %                %  %
%  %                %                %  %
%  %                %                %  %
%  %                %                %  %
%  %                %                %  %
%  %                %                %  %
%  %                %                %  %
%  %                %                %  %
%  %                %                %  %
%  %                %                %  %
%  %                %                %  %
%  %                %                %  %
%  %                %                %  %
%                                       %
%   %%%%%%%%%%%%%%%   %%%%%%%%%%%%%%%   %
%                                       %
%  %                %                %  %
%  %                %                %  %
%  %                %                %  %
%  %                %                %  %
%  %                %                %  %
%  %                %                %  %
%  %                %                %  %
%  %                %                %  %
%  %                %                %  %
%  %                %                %  %
%  %                %                %  %
%  %                %                %  %
%  %                %                %  %
%  %                %                %  %
%                   %                   %
%    %%%%%%%%%%%%%%   %%%%%%%%%%%%%%    %
%                                       %
%                                       %
%%%%%%%%%%%%%%%%%%%%%%%%%%%%%%%%%%%%%%%%%
