%%%%%%%%%%%%%%%%%%%%%%%%%%%%%%%%%%%%%%%%%
%                                       %
%                                       %
%                                       %
%                                       %
%    %%%%%%%%%%%%%%%%%%%%%%%%%%%%%%%    %
%                                       %
%                                       %
%                                       %
%                                       %
%    %%%%%%%%%%%%%%%%%%%%%%%%%%%%%%%    %
%                                       %
%                                       %
%                                       %
%                                       %
%    %%%%%%%%%%%%%%%%%%%%%%%%%%%%%%%    %
%                                       %
%                                       %
%                                       %
%                                       %
%    %%%%%%%%%%%%%%%%%%%%%%%%%%%%%%%    %
%                                       %
%                                       %
%                                       %
%                                       %
%    %%%%%%%%%%%%%%%%%%%%%%%%%%%%%%%    %
%                                       %
%                                       %
%                                       %
%                                       %
%    %%%%%%%%%%%%%%%%%%%%%%%%%%%%%%%    %
%                                       %
%                                       %
%                                       %
%                                       %
%    %%%%%%%%%%%%%%%%%%%%%%%%%%%%%%%    %
%                                       %
%                                       %
%                                       %
%                                       %
%%%%%%%%%%%%%%%%%%%%%%%%%%%%%%%%%%%%%%%%%
