%%%%%%%%%%%%%%%%%%%%%%%%%%%%%%%%%%%%%%%%%
%                                       %
%                                       %
%  %                                 %  %
%   %                               %   %
%    %                             %    %
%     %                           %     %
%      %                         %      %
%       %                       %       %
%        %                     %        %
%         %                   %         %
%          %                 %          %
%           %               %           %
%            %             %            %
%             %           %             %
%              %         %              %
%               %       %               %
%                %     %                %
%                 %   %                 %
%                  % %                  %
%                                       %
%                  % %                  %
%                 %   %                 %
%                %     %                %
%               %       %               %
%              %         %              %
%             %           %             %
%            %             %            %
%           %               %           %
%          %                 %          %
%         %                   %         %
%        %                     %        %
%       %                       %       %
%      %                         %      %
%     %                           %     %
%    %                             %    %
%   %                               %   %
%  %                                 %  %
%                                       %
%                                       %
%%%%%%%%%%%%%%%%%%%%%%%%%%%%%%%%%%%%%%%%%
