%%%%%%%%%%%%%%%%%%%%%%%%%%%%%%%%%%%%%%%%%
%                                       %
%                                       %
%                %%%%%%%                %
%             %%%%%%%%%%%%%             %
%           %%%%%%%%%%%%%%%%%           %
%         %%%%%%%%%%%%%%%%%%%%%         %
%        %%%%%%%%%%%%%%%%%%%%%%%        %
%       %%%%%%%%%%%%%%%%%%%%%%%%%       %
%      %%%%%%%%%%%%%%%%%%%%%%%%%%%      %
%     %%%%%%%%%%%%%%%%%%%%%%%%%%%%%     %
%     %%%%%%%%%%%%%%%%%%%%%%%%%%%%%     %
%    %%%%%%%%%%%%%%%%%%%%%%%%%%%%%%%    %
%    %%%%%%%%%%%%%%%%%%%%%%%%%%%%%%%    %
%   %%%%%%%%%%%%%%%%%%%%%%%%%%%%%%%%%   %
%   %%%%%%%%%%%%%%%%%%%%%%%%%%%%%%%%%   %
%   %%%%%%%%%%%%%%%%%%%%%%%%%%%%%%%%%   %
%  %%%%%%%%%%%%%%%%%%%%%%%%%%%%%%%%%%%  %
%  %%%%%%%%%%%%%%%%%%%%%%%%%%%%%%%%%%%  %
%  %%%%%%%%%%%%%%%%%%%%%%%%%%%%%%%%%%%  %
%  %%%%%%%%%%%%%%%%%%%%%%%%%%%%%%%%%%%  %
%  %%%%%%%%%%%%%%%%%%%%%%%%%%%%%%%%%%%  %
%  %%%%%%%%%%%%%%%%%%%%%%%%%%%%%%%%%%%  %
%  %%%%%%%%%%%%%%%%%%%%%%%%%%%%%%%%%%%  %
%   %%%%%%%%%%%%%%%%%%%%%%%%%%%%%%%%%   %
%   %%%%%%%%%%%%%%%%%%%%%%%%%%%%%%%%%   %
%   %%%%%%%%%%%%%%%%%%%%%%%%%%%%%%%%%   %
%    %%%%%%%%%%%%%%%%%%%%%%%%%%%%%%%    %
%    %%%%%%%%%%%%%%%%%%%%%%%%%%%%%%%    %
%     %%%%%%%%%%%%%%%%%%%%%%%%%%%%%     %
%     %%%%%%%%%%%%%%%%%%%%%%%%%%%%%     %
%      %%%%%%%%%%%%%%%%%%%%%%%%%%%      %
%       %%%%%%%%%%%%%%%%%%%%%%%%%       %
%        %%%%%%%%%%%%%%%%%%%%%%%        %
%     T   %%%%%%%%%%%%%%%%%%%%%         %
%           %%%%%%%%%%%%%%%%%           %
%             %%%%%%%%%%%%% P           %
%                %%%%%%%                %
%                        P              %
%                                       %
%%%%%%%%%%%%%%%%%%%%%%%%%%%%%%%%%%%%%%%%%
