%%%%%%%%%%%%%%%%%%%%%%%%%%%%%%%%%%%
%    P                            %
%    P   %      %%%%              %
%    P   %%                       %
%        %%%%%%%%%%% T            %
%        %%                       %
%        %%%%%%%%%%%              %
%                                 %
%                                 %
%%%%%%%%%%%%%%%%%%%%%%%%%%%%%%%%%%%
