%%%%%%%%%%%%%%%%%%%%%%%%%%%%%%%%%%%
%    P                            %
%    P   %      %%%%              %
%    P   %%                       %
%        %%%%%%%%%%% T            %
%        %%                       %
%        %%%%%%%%%%%              %
%  P       P                      %
%           P                     %
%%%%%%%%%%%%%%%%%%%%%%%%%%%%%%%%%%%
