%%%%%%%%%%%%%%%%%%
%                %
%           T    %
%    %%%%%%%     %
%    %%%%%%%     %
%    %%%%%%%     %
%    %%%%%%%     %
%    %%%%%%%     %
%P     P         %
%%%%%%%%%%%%%%%%%%
