%%%%%%%%%%%%%%%%%%%%
%                  %
%               T  %
%    %%%%%%%%%%%   %
%    %%%%%%%%%%%   %
% P  %%%%%%%%%%%   %
%    %%%%%%%%%%%   %
% P  %%%%%%%%%%%   %
%             P    %
%%%%%%%%%%%%%%%%%%%%
