%%%%%%%%%%%%%%%%%%%%
%                  %
%                  %
%    %%%%%%%%%%%   %
%    %%%%%%%%%%%   %
%    %%%%%%%%%%%   %
%    %%%%%%%%%%%   %
%    %%%%%%%%%%%   %
%                  %
%%%%%%%%%%%%%%%%%%%%
