%%%%%%%%%%%%%%%%%%%%%%%%%%%%%%%%%%%%%%%%%%%%%
%                                           %
%                                           %
%    %%%%%%%    %%%%%%%      %%%%%%%%%      %
%    %%%%%%%                        T%      %
%    %%%%%%%       %%%%%%%           %      %
%    %%%%%%%       %%%%%%%           %      %
%    %%%%%%%       %%%%%%%%%%%%%   %%%      %
%    %%%%%%%       %%%%%%%           %      %
%    %%%%%%%       %%%%%%%           %      %
%    %%%%%%%       %%%%%%%   %%%%%%%%%P     %
%    %%%%%%%       %%%%%%%           %      %
%    %%%%%%%       %           P     %      %
%    %%%%%%%       %     %%%%%%%%%%%%%      %
%                                    P      %
%%%%%%%%%%%%%%%%%%%%%%%%%%%%%%%%%%%%%%%%%%%%%
