%%%%%%%%%%%%%%%%%%%%%%%%%%%%%%%%%%%%%%%%%%%%%
%                                           %
%                                           %
%    %%%%%%%    %%%%%%%      %%%%%%%%%      %
%    %%%%%%%                         %      %
%    %%%%%%%       %%%%%%%           %      %
%    %%%%%%%       %%%%%%%           %      %
%    %%%%%%%       %%%%%%%%%%%%%   %%%      %
%    %%%%%%%       %%%%%%%           %      %
%    %%%%%%%       %%%%%%%           %      %
%    %%%%%%%       %%%%%%%   %%%%%%%%%      %
%    %%%%%%%       %%%%%%%           %      %
%    %%%%%%%       %                 %      %
%    %%%%%%%       %     %%%%%%%%%%%%%      %
%                                           %
%%%%%%%%%%%%%%%%%%%%%%%%%%%%%%%%%%%%%%%%%%%%%
