%%%%%%%%%%%%%%%%%%%%%%%%%%%%%%%%%%%%%%%%%%%%%
%                                           %
%           T                               %
%    %%%%%%%    %%%%%%%      %%%%%%%%%      %
%    %%%%%%%                         %      %
%    %%%%%%%       %%%%%%%           %      %
%    %%%%%%%       %  P  %           %      %
%    %%%%%%%       %     %%%%%%%%%%%%%      %
%P                                          %
%%%%%%%%%%%%%%%%%%%%%%%%%%%%%%%%%%%%%%%%%%%%%
