%%%%%%%%%%%%%%%%%%%%%%%%%%%%%%%%%%%%%%%%%%%%%
%                                           %
%                                           %
%    %%%%%%%    %%%%%%%      %%%%%%%%%      %
%    %%%%%%%                         %      %
%    %%%%%%%       %%%%%%%           %      %
%    %%%%%%%       %%%%%%%           %      %
%    %%%%%%%       %%%%%%%%%%%%%   %%%      %
%    %%%%%%%       %%%%%%%P          %      %
%    %%%%%%%       %%%%%%%           %      %
%    %%%%%%%       %%%%%%%   %%%%%%%%%      %
%    %%%%%%%       %%%%%%%           %      %
%    %%%%%%%       %              P  %      %
%    %%%%%%%       %     %%%%%%%%%%%%%      %
% T                                         %
%%%%%%%%%%%%%%%%%%%%%%%%%%%%%%%%%%%%%%%%%%%%%
