%%%%%%%%%%%%%%%%%%%%%%%%%%%%%%%%%%%%%%%%%
%    %     %     %     %     %     %    %
%    %     %     %     %     %     %    %
%    %     %     %     %     %     %    %
%                                       %
%%%%   %%%   %%%   %%%   %%%   %%%   %%%%
%                                       %
%    %                             %    %
%    %                             %    %
%    %                             %    %
%             T                         %
%%%%      %%%%%%%%%%%%%%%%%%%%%      %%%%
%         %%%%%%%%%%%%%%%%%%%%%         %
%    %    %%%%%%%%%%%%%%%%%%%%%    %    %
%    %    %%%%%%%%%%%%%%%%%%%%%    %    %
%    %    %%%%%%%%%%%%%%%%%%%%%    %    %
%         %%%%%%%%%%%%%%%%%%%%%         %
%%%%      %%%%%%%%%%%%%%%%%%%%%      %%%%
%         %%%%%%%%%%%%%%%%%%%%%         %
%    %    %%%%%%%%%%%%%%%%%%%%%    %    %
%    %    %%%%%%%%%%%%%%%%%%%%%    %    %
%    %    %%%%%%%%%%%%%%%%%%%%%    %    %
%         %%%%%%%%%%%%%%%%%%%%%         %
%%%%      %%%%%%%%%%%%%%%%%%%%%      %%%%
%         %%%%%%%%%%%%%%%%%%%%%         %
%    %    %%%%%%%%%%%%%%%%%%%%%    %    %
%    %    %%%%%%%%%%%%%%%%%%%%%    %    %
%    %    %%%%%%%%%%%%%%%%%%%%%    %    %
%         %%%%%%%%%%%%%%%%%%%%%         %
%%%%      %%%%%%%%%%%%%%%%%%%%%      %%%%
%                 PPP                   %
%    %                             %    %
%    %                             %    %
%    %                             %    %
%                                       %
%%%%   %%%   %%%   %%%   %%%   %%%   %%%%
%                                       %
%    %     %     %     %     %     %    %
%    %     %     %     %     %     %    %
%    %     %     %     %     %     %    %
%%%%%%%%%%%%%%%%%%%%%%%%%%%%%%%%%%%%%%%%%
