%%%%%%%%%%%%%%%%%%%%%%%%%%%%%%%%%%%%%%%%%%%%%%%%%%%%%%%%%%%%%%%%%%%%%%%%%%%%%%%%%%%%%%%%%%%%%%%%%%%%
%                                                                 %                                %
%                                                                 %                                %
%                                                                 %                                %
%                                                                 %                                %
%                                                                 %             %%%%               %
%                                                      %          %             %%%%               %
%                                                     %%%         %             %%%%               %
%                            %%%%                   %%%%%%%       %%%%%%%%%%%%%%%%%%               %
%                         %%%%%%%%%%%          %%%%%%%%%          %                                %
%                           %%%%%%%%%%%%%          %%%%%%         %                                %
%                             %%%%%%%%%%              %%%%                                         %
%      %%%                     %%%%%%%%%           %%%%%%                                          %
%      %%%                      %%%%%%%%        %%%%%%%%                              %%%%%%   %%%%%
%        %                        %%%%%             %%%%%         %                   %            %
%      %%%                         %%%                            %%%%%%%%%%%%%%%%%%%%%            %
%      %%%                 %%%     %%                             %          %                     %
%                          %%%     %%              %%             %          %                     %
%                           %%                   %%%%%                       %                     %
%                          %%                     %%%                        %                     %
%                           %      %%%             %%                        %                     %
%                                 %%%%%                           %          %                     %
%                                  %%%%                           %          %                     %
%                                                                 %          %                     %
%                                           %%%%                  %          %                     %
%                            %%%         %%%%%%%%%                %          %                     %
%                           %%%%%     %%%%%%%%%%%              %%%%          %         %%%%        %
%              %%            %%%       %%%%%%%%%%           %%%%%%%          %         %%%%        %
%              %%             %%         %%%%%%%%         %%%%%%%%%          %         %%%%        %
%              %%              %%          %%%%%%%            %%%%%          %         %%%%        %
%              %%               %           %%%%%                %%          %            %%%%%%%%%%
%                                           %%%%                  %          %            %        %
%                                           %%%        %%%        %          %            %        %
%                                           %%       %%%%%%%%     %          %            %        %
%                                                     %%%%%       %          %%%%%%%%%%%%%%        %
%                                                      %%%%       %                                %
%                                 %%%                   %%        %                                %
%                                %%%%%                  %         %                                %
%                              %%%%%%%%                           %                                %
%                               %%%%%%%%                          %                                %
%        %%%%%%                 %%%   %%%%                        %                                %
%        %%%%%%                %%      %%%%               %       %%%%%%%%%%%%%%%%%%%        %%%%%%%
%                               %         %%          %%%%%       %              %%%%              %
%                                                  %%%%%%%%%      %              %%%%              %
%                                               %%%%%%%%%%%%      %                                %
%                                                     %%%%        %                                %
%                                                     %%          %                                %
%                                                                                   %%%%%%%        %
%                                       %%%%%%%%%%                                  %%%%%%%        %
%                                  %%%%%%%%%%%%%%%%%%%                              %%%%%%%        %
%         %%%%%%                      %%%%%%%%%%%%%%%%%                             %%%%%%%        %
%         %%                            %%%%%%%%%%%%%%                              %%%%%%%        %
%         %%              %%%             %%%%%%%%%%%             %                                %
%         %%            %%%%%                %%%%%%%              %                                %
%                         %%                                      %                                %
%                          %%                                     %                                %
%                          %%                                     %                                %
%                         %%%                                     %%%%%%%%%%%%%%%%%%%%%%%%%%%%%    %
%                         %%                                      %                                %
%                                      %%%%                       %                                %
%%%%%                               %%%%%%%%                      %                                %
%%%%%                                  %%%%%%%%    %%             %                                %
%                                    %%%%%%%      %%%%%           %                                %
%                                       %%%%       %%%%           %                  %             %
%                                      %%%%          %%           %                  %             %
%                                       %%%%                                         %             %
%                                        %%%                                         %             %
%                                        %%                                          %             %
%                                         %                       %%%%%%%%%%%%%%%%%%%%%%%%%%%%%%%%%%
%            %                  %%%%%%%%                          %                                %
%            %               %%%%%%%%%%                           %                                %
%            %%%                %%%%%%%%                %         %                                %
%            %%%                  %%%%%                 %%        %                                %
%                                   %%%              %%%%%        %                                %
%                                  %%%             %%%%%%                                          %
%                                                   %%%%%%%                                        %
%                                                                                                  %
%                                                                                                  %
%         %%                                                      %                  %%%%%%%%%%%%%%%
%         %%                          %%%%%%                      %                  %        %%%%%%
%         %%                       %%%%%%%%%%                     %                  %        %%%%%%
%         %%                         %%%%%%                       %                  %        %%%%%%
%         %%                          %%%%%                       %                  %             %
%                                     %%%%%                       %                  %             %
%                                       %%%                       %                                %
%                                                                 %%%%%%                           %
%                                                        %%%%     %                                %
%                                %%%%              %%%%%%%        %                  %             %
%                            %%%%%%%%%%           %%%%%           %                  %             %
%                         %%%%%%%%%%%            %%%%             %                  %             %
%                        %%%%%%%%%                  %%%%          %                  %             %
%                       %%%%                          %%%%        %                  %             %
%        %%              %%                            %%         %                  %             %
%        %%%%             %                             %%        %                  %             %
%                                                                 %                  %             %
%                                        %%%%                     %                  %             %
%                                      %%%%%%%                   %%                  %%%%%%        %
%                                  %%%%%%%%%                   %%%%                  %%%%%%        %
%                                %%%%%%%%%%%                 %%%%%%                  %%%%%%        %
%%%%%%%%%%%%%%%%%%%%%%%%%%%%%%%%%%%%%%%%%%%%%%%%%%%%%%%%%%%%%%%%%%%%%%%%%%%%%%%%%%%%%%%%%%%%%%%%%%%%
