%%%%%%%%%%%%%%%%%%
%                %
%                %
%    %%%%%%%     %
%    %%%%%%%     %
%    %%%%%%%     %
%    %%%%%%%     %
%    %%%%%%%     %
%                %
% %%%%%%%%%%%%   %
%                %
%                %
%                %
%                %
%                %
%                %
%                %
%%%%%%%%%%%%%%%%%%