%%%%%%%%%%%%%%%%%%
%                %
%                %
%    %%%%%%%     %
%    %%%%%%%     %
%    %%%%%%%     %
%    %%%%%%%     %
%    %%%%%%%     %
%     T          %
% %%%%%%%%%%%%   %
%                %
% P              %
%                %
%   P            %
%                %
%                %
%P               %
%%%%%%%%%%%%%%%%%%