%%%%%%%%%%%
%         %
%    %    %
%   %%%   %
%  %%%%%  %
%T%%%%%%% %
%  %%%%% P%
%   %%% P %
%    %    %
%         %
%%%%%%%%%%%