%%%%%%%%%%%
%         %
%    %    %
%   %%%   %
%  %%%%%  %
% %%%%%%% %
%  %%%%%  %
%   %%%   %
%    %    %
%         %
%%%%%%%%%%%