%%%%%%%%%%%
%         %
%    %    %
%T  %%%   %
%  %%%%%  %
% %%%%%%% %
% %%%%%%% %
%  %%%%%P %
%   %%% P %
%    %    %
%         %
%%%%%%%%%%%