%%%%%%%%%%%
%         %
%    % T  %
%   %%%   %
%  %%%%%  %
% %%%%%%% %
% %%%%%%% %
%  %%%%%  %
%   %%%   %
% PP %    %
%         %
%%%%%%%%%%%