%%%%%%%%%%%
%         %
%    %    %
%   %%%   %
%  %%%%%  %
% %%%%%%%P%
% %%%%%%%P%
%T %%%%%  %
%   %%%   %
%    %    %
%         %
%%%%%%%%%%%