%%%%%%%%%%%%%%%%%%%%%%%%%%%%%%%%%%%%%%%%%%%%%%%%%%%%
%                                                  %
%                                                  %
%    %%%%%%%      %%%%%%%                          %
%  P %%%%%%%       %%%%%%%                         %
%    %%%%%%% T     %%%%%%%                         %
%    %%%%%%%        %%%%%%%                        %
%    %%%%%%%        %%%%%%%                        %
%   P                                              %
% %%%%%%%%%%%%                                     %
%  P                                               %
%                                                  %
%                        %%%%%%%%%%%%%%            %
%                        %%%%%%%%%%%%%%            %
%                        %%%%%%%%%%%%%%            %
%                                                  %
%                                                  %
%%%%%%%%%%%%%%%%%%%%%%%%%%%%%%%%%%%%%%%%%%%%%%%%%%%%