%%%%%%%%%%%%%%%%%%%%%%%%%%%%%%%%%%%%%%%%%%%%%%%%%%%%
%                                                  %
%                                                  %
%    %%%%%%%      %%%%%%%                          %
%    %%%%%%%       %%%%%%%                         %
%    %%%%%%%       %%%%%%%                         %
%    %%%%%%%        %%%%%%%                        %
%    %%%%%%%        %%%%%%%                        %
%                                                  %
% %%%%%%%%%%%%                                     %
%                                                  %
%                                                  %
%                        %%%%%%%%%%%%%%            %
%                        %%%%%%%%%%%%%%            %
%                        %%%%%%%%%%%%%%            %
%                                                  %
%                                                  %
%%%%%%%%%%%%%%%%%%%%%%%%%%%%%%%%%%%%%%%%%%%%%%%%%%%%