%%%%%%%%%%%%
%          %
%          %
%          %
%          %
%          %
%          %
%          %
%          %
%          %
%          %
%%%%%%%%%%%%